Chinese, Simplified - 简体中文: 存钱猪猪
Arabic - 阿拉伯语: حصالة نقود
Catalan - 加泰罗尼亚语: guardiola
Chinese (Hong Kong) - 香港繁体中文: 存錢豬豬
Chinese, Traditional - 繁体中文: 存錢豬豬
Croatian - 克罗地亚语: kasica prasica
Czech - 捷克语: prasátko na spoření
Danish - 丹麦语: sparegris
Dutch - 荷兰语: spaarvarken
English - 英语: piggy bank
English (Australia) - 英语（澳大利亚）: piggy bank
English (Canada) - 英语（加拿大）： piggy bank
English (India) - 英语（印度）: piggy bank
English (United Kingdom) - 英语（英国）: piggy bank
Finnish - 芬兰语: säästöpossu
French - 法语: tirelire
French (Canada) - 法语（加拿大）: tirelire
German - 德语: Sparschwein
Greek - 希腊语: κουμπαράς
Hebrew - 希伯来语: קופת חיסכון
Hindi - 印地语: गुल्लक
Hungarian - 匈牙利语: malacpersely
Indonesian - 印度尼西亚语: celengan
Italian - 意大利语: salvadanaio
Japanese - 日语: 貯金箱
Korean - 韩语: 저금통
Malay - 马来语: tabung
Norwegian Bokmål - 挪威语（博克马尔语）: sparegris
Polish - 波兰语: skarbonka
Portuguese (Brazil) - 葡萄牙语（巴西）: cofrinho
Portuguese (Portugal) - 葡萄牙语（葡萄牙）: mealheiro
Romanian - 罗马尼亚语: pușculiță
Russian - 俄语: копилка
Slovak - 斯洛伐克语: prasiatko na sporenie
Spanish - 西班牙语: hucha
Spanish (Latin America) - 西班牙语（拉丁美洲）: alcancía
Swedish - 瑞典语: spargris
Thai - 泰语: กระปุกออมสิน
Turkish - 土耳其语: kumbara
Ukrainian - 乌克兰语: скарбничка
Vietnamese - 越南语: ống heo