明白了，这里是将“赞助存钱猪猪”翻译成40种语言的结果：

Chinese, Simplified - 简体中文: 赞助存钱猪猪
Arabic - 阿拉伯语: رعاية حصالة نقود
Catalan - 加泰罗尼亚语: patrocina una guardiola
Chinese (Hong Kong) - 香港繁体中文: 贊助存錢豬豬
Chinese, Traditional - 繁体中文: 贊助存錢豬豬
Croatian - 克罗地亚语: sponzoriraj kasicu prasicu
Czech - 捷克语: sponzorovat spořící prasátko
Danish - 丹麦语: sponsor sparegris
Dutch - 荷兰语: sponsor het spaarvarken
English - 英语: sponsor piggy bank
English (Australia) - 英语（澳大利亚）: sponsor piggy bank
English (Canada) - 英语（加拿大）: sponsor piggy bank
English (India) - 英语（印度）: sponsor piggy bank
English (United Kingdom) - 英语（英国）: sponsor piggy bank
Finnish - 芬兰语: sponsoroi säästöpossu
French - 法语: parrainer une tirelire
French (Canada) - 法语（加拿大）: parrainer une tirelire
German - 德语: das Sparschwein sponsern
Greek - 希腊语: χορηγήστε κουμπαρά
Hebrew - 希伯来语: נותן חסות לקופת חיסכון
Hindi - 印地语: गुल्लक को प्रायोजित करें
Hungarian - 匈牙利语: támogassa a malacperselyt
Indonesian - 印度尼西亚语: mensponsori celengan
Italian - 意大利语: sponsorizza un salvadanaio
Japanese - 日语: 貯金箱を支援する
Korean - 韩语: 저금통을 후원하다
Malay - 马来语: taja tabung
Norwegian Bokmål - 挪威语（博克马尔语）: spons en sparegris
Polish - 波兰语: sponsoruj skarbonkę
Portuguese (Brazil) - 葡萄牙语（巴西）: patrocinar cofrinho
Portuguese (Portugal) - 葡萄牙语（葡萄牙）: patrocinar mealheiro
Romanian - 罗马尼亚语: sponsorizează o pușculiță
Russian - 俄语: спонсировать копилку
Slovak - 斯洛伐克语: Sponzorované aplikácie
Spanish - 西班牙语: patrocina una hucha
Spanish (Latin America) - 西班牙语（拉丁美洲）: patrocinar una alcancía
Swedish - 瑞典语: sponsra spargris
Thai - 泰语: สนับสนุนกระปุกออมสิน
Turkish - 土耳其语: kumbara sponsoru ol
Ukrainian - 乌克兰语: спонсорувати скарбничку
Vietnamese - 越南语: tài trợ ống heo